########...#########
#..................#
#..#######.........#
#.............#....#
d.............#....#
d..####.......#....#
d..#..........#....#
#..#..m...#........#
#..#....####....s..#
#..................#
####################