####################
#a.................#
#..#######.........#
#......s......#....#
d.............#.....
d..####...m...#.....
d..#..........#.....
#..#..m...#..s.....#
#..#....####.......#
#..................#
####################