###########################
#.......m.................#
#...............####......#
#......#..................#
#......#..................#
#......#.......c..........d
#...k..#..................#
#......#..................#
#......#............m.....#
#.........................#
###########################