##############################################
#............................................#
#..............................####..........#
#.....................#......................#
#.....................#......................#
#.....................#......................d
#..........k..........#......................#
#.....................#......................#
#.....................#......................#
#............................................#
##############################################