####################
...................#
..........##########
#.........#c.......#
#.........#####....#
#.............#...##
#.........######...#
#..................#
#.........##########
#..................#
########ddd#########