######dddddddd######
#..................#
#.........##########
d.........#c.......#
d.........#####....#
d.............#...##
d.........######...#
d..................#
#.........##########
#..............k...#
####################