####################
#.......m..........#
#..s.........####..#
#......##....####..d
#......##..........d
#...k..##....a.....d
#......##.....#....d
#......##..........d
#......##........m.#
#..........c.......#
####################