####################
#a..........s......#
#..................#
#......s....###....#
d...................
d...###...m.........
d...................
#.....m...#..s.....#
#.......####.......#
#.s..s.......s.....#
####################