#############d#############
#......................k..#
#.........###########.....#
#.........#c........#.....#
#.........#########.#.....#
d.................#.#.....#
#.........#########.#.....#
#...................#.....#
#.........###########.....#
#.........................#
###########################