####################
#..................#
#....#.............#
#....#.............#
#....####..........d
#..................d
#..................d
#.......#######....#
#.............#....#
#.............#....#
####################