####################
#..................#
#..######..######..#
#..##..s.......##..#
#..#............#...
#.........b.........
#..#............#...
#..##.m......s.##..#
#..######..######..#
#..................#
####################