####################
#..................#
#.........##########
#.........#c.......#
d.........#####....#
d.............#...##
d.........######...#
#..................#
#...m.....##########
#..................#
########dddd########