####################
#...........#......d
#....########......d
#....#......#..#####
.....#......#......#
.....#..#...#......#
.....#..#...#####..#
#....#..#...#......#
#.......#..........#
#.......#..........#
####################