####################
#..................#
#..................#
#..................#
#...................
#........w..........
#...................
#..................#
#..................#
#..................#
####################