########dddd########
#..................#
#..#######.........#
#......s.#....#....#
d........#....#....#
d..####...m...#....#
d..#......#####....#
#..#..m...#..s.....#
#..#....####.......#
#.................a#
####################