####################
#..................#
#.........##########
#.........#c.......#
..........#####....#
....w.........#...##
..........######...#
#..................#
#...m.....##########
#..................#
########ddd#########