####################
#..................#
#..######..######..#
#..##..s.......##..#
#..#............#..d
#.........b........d
#..#............#..d
#..##.m......s.##..#
#..######..######..#
#..................#
####################