###########################
#.......m.................#
#...............####......#
#......#..................#
#......#..................#
#......#..................d
#...k..#..................#
#......#..................#
#......#............m.....#
#..........c..............#
###########################