####################
#..................#
#..........s.......#
#....s.............#
#...................
#........w..........
#......s............
#..................#
#....s.............#
#.............s....#
####################