####################
#.......m..........#
#............####..#
#......##....####..d
#......##..........d
#...k..##..........d
#......##.....#....d
#......##..........d
#......##........m.#
#..........c.......#
####################