###########################
#.........................#
#...............####......#
#......#..................#
#......#..................#
#......#..................d
#...k..#..................#
#......#..................#
#......#..................#
#.........................#
###########################